. . . . . . . . . . . . . . . .
. . . . . . # # . . . . . . . .
. . . . . # X X # . . . . . . .
. . . . # X O O X # . . . . . .
. . . . # X O O X # . . . . . .
. . . # X X O O X X # . . . . .
. . . # X X + + X X # . . . . .
. . . . # X O O X # . . . . . .
. . . . # X O O X # . . . . . .
. . . . . # X X # . . . . . . .
. . . . . . # # . . . . . . . .
. . . . . . . . . . . . . . . .
