. . . . . . . . . . . . . . . .
. . . . . . . # . . . . . . . .
. . . . . . # # . . . . . . . .
. . . . . # X # . . . . . . . .
. . . . # X O X # . . . . . . .
. . . # X O O O X # . . . . . .
. . . # X O + O X # . . . . . .
. . . . # X O X # . . . . . . .
. . . . . # X # . . . . . . . .
. . . . . # # . . . . . . . . .
. . . . . # . . . . . . . . . .
. . . . . . . . . . . . . . . .
