. . . . . . . . . . . . . . . .
. . . . . . X X . . . . . . . .
. . . . . # O O # . . . . . . .
. . . . # # O O # # . . . . . .
. . . . # + # # + # . . . . . .
. . . # # + # # + # # . . . . .
. . . # # # # # # # # . . . . .
. . . # # O # # O # # . . . . .
. . . # # # # # # # # . . . . .
. . . # # # # # # # # . . . . .
. . # # # # # # # # # # . . . .
. . . . . . . . . . . . . . . .
